R 140 30
NO ./maps/city/building.xpm
SO ./maps/city/building4.xpm
EA ./maps/city/building3.xpm
WE ./maps/city/building2.xpm

S ./banana.xpm
F 96, 128, 56
C 51,171,249

111111111
100001001
10E001001
100000001
111111111