R 200 100
NO ./maps/city/building.xpm
SO ./maps/city/building4.xpm
EA ./maps/city/building3.xpm
WE ./maps/city/building2.xpm

S ./banana.xpm
F 96, 128, 56
C 51,171,249

11111111111111111111111111111
10101010101010101010101010101
10101010101010101010101010101
10101010101010101010101010101
10101010101010101010101010101
10001000100010001000100010101
10001000100010001000100010101
10000000000010000000100010101
10000000000010000000100010101
10000000000010000000100010101
10000000000010W00200100010101
10000000000200000020000000001
11111111111111111111111111111