R 140 30
NO ./maps/city/building.xpm
SO ./maps/city/building4.xpm
EA ./maps/city/building3.xpm
WE ./maps/city/building2.xpm

S ./banana.xpm
F 96, 128, 56
C 51,171,249

11111111111
10000100101
10000100001
1000W000101
11111111111