R 90 30
NO ./maps/city/building.xpm
SO ./maps/city/building4.xpm
EA ./maps/city/building3.xpm
WE ./maps/city/building2.xpm

S ./banana.xpm
F 96, 128, 56
C 51,171,249

11111111111
10000100101
11000100001
1000S000101
11100000001
10000110101
10110010001
10000100001
11000100001
10010000001
10000000101
10000001001
10001000001
10000000001
11111111111