R      1020 500
NO ./path_to_the_north_texture
SO ./path_to_the_south_texture
WE ./path_to_the_west_texture
EA ./path_to_the_east_texture
S ./path_to_the_sprite_texture

F 220,100,0
C 225,30,0

1111111
1201021
1000001
1002001
1002001
1000001
1001001
1000001
1001001
1111111