R 1000 500
NO ./asdf
SO ./asdf
EA ./asdf
WE ./asdf

S ./asdf
F 220,100,0
C 225,30,0

11111111111111111111111111111
12000000000000000000000000021
12200000000000020000000000021
12000000000000202000000000001
10000000000002000200000000001
100000000000000W0000000000001
10000000000000000000000000001
10000000000000000000000000001
11111111000000022000000001111
10000000000000000000000000001
10000000000000000000000000001
10000000000000000000000000001
11111111111111111111111111111